******************************************************
*........................****........................*
*.**********.***********.****.***********.**********.*
*.....******.***********.****.***********.******.....*
*.***.******.***********.****.***********.******.***.*
*.***.******.***********.****.***********.******.***.*
*.***.******.***********......***********.******.***.*
*........................****........................*
*.**********.***.*****.********.*****.***.**********.*
*.**********.***.*****.********.*****.***.**********.*
*...********.***.*****.********.*****.***.********...*
***.********.***.*****.********.*****.***.********.***
*........................****........................*
***.********.***********......***********.********.***
***.********.***********.****.***********.********.***
*...********.***********.****.***********.********...*
*.**********.***********.****.***********.**********.*
*........................****........................*
******************************************************
