******************************************************
*........................****........................*
*.*****.****.****.***.**.****.***********.**********.*
*.....*.****......***.**.****.***********.******.....*
*.***.*..***.****.***.**.****........****.******.***.*
*.***.**.***.****.***.**.****.******.****........***.*
*.***.**.***.****.***.**......******.****.******.***.*
*........................****........................*
*.******.***.***.**.**.********.**.**.***.*****.****.*
*.******.***.***.**.**.********.**.**.***.*****.****.*
*...****.***.***.**.**.********.**.**.***.**....**...*
***.****.***.***.**.**.********.**.**.***.**.*****.***
*........................****........................*
***.***.****.****.******......********.**.**.*****.***
***.***.****......******.****.********.**.**.*****.***
*...***.****.****........****.***......**.**....**...*
*.*****.****.****.******.****.***.*******.*****.****.*
*........................****........................*
******************************************************
